11111111111111111111111111111111
12222222222222222222222222222221
12000000000000000000000000000021
12000000000000000000000000000021
12000000000000000000040000000021
12000000000000000000000000000021
12000000000000000000000000000021
12000000000000000000000000000021
12000000000000000000000000000021
12220002222222222222222220002221
12000000000000000000000000000021
12000000000000000000000000000021
12000000500000000000000000000021
12000000000000000000000000000021
12220002222222222222222220002221
12000000000000000000000000000021
12000000000000000000000000000021
11111111111111111200000000000021
12000000000000000000000000000021
12000000000000000000000000000021
11111111111111111111111111111111