0000000000000000000000000000000000000000000000000000000000
0111111111111111111111111111111111111111111111111110011110
0122222222222222222222222222222222222222222222222210012210
0122222422222222222222222222222222222222222222222210012210
0122111122111111111122111122111122111111111111112210012210
0122100122100000000122100122100122100000000000012210012210
0122100122100000000122100122100122100000000000012210012210
0122100122111111100122111122111122111111111111112211112210
0122100122222222100122222222222222222222222222222222222210
0122111122222222100122222222222222222222222222222222222210
0122222222111122100122111122111111112211112211112211112210
0122222222100122100122100122100000012210012210012210012210
0122111122100122100122100122100000012210012210012210012210
0122100122111122111122111122111111112211112211112211112210
0122100122222222222222222222222222222222222222222222222210
0122100122222222222222222222222222222222222222222224222210
0122100122111122111122111112211111112211112211112211112210
0122100122100122100122100012210000012210012210012210012210
0122100122100122100122100012210000012210012210012210012210
0122111122111122111122111112211111112211112211112210012210
0122222222222222222222222225222222222422222222222210012210
0122222222222222222222222222222222222222222222222210012210
0122111122111122111122111111221111112211112211112210012210
0122100122100122100122100001221000012210012210012210012210
0122100122100122100122100001221000012210012210012210012210
0122100122111122100122100001221000012210012211112211112210
0122100122222222100122100001221000012210012222222222222210
0122100122222222100122100001221000012210012222222222222210
0122100122111122100122100001221000012210012211112211112210
0122100122100122100122100001221000012210012210012210012210
0122100122100122100122100001221000012210012210012210012210
0122111122111122111122111111221111112211112210012211112210
0122222222222222222222222222222222222222222210012222222210
0122222222222222222222222222222222222222222210012222222210
0122111111111122111122111122111111112211111110012211112210
0122100000000122100122100122100000012210000000012210012210
0122100000000122100122100122100000012210000000012210012210
0122100111111122111122111122111111112211111111112211112210
0122100122222222222222222222224222222222222222222222222210
0122100122222222222222222222222222222222222222222222222210
0122100122111122111111111122111111112211112211112211112210
0122100122100122100000000122100000012210012210012210012210
0122100122100122100000000122100000012210012210012210012210
0122111122111122111111111122111111112211112211112210012210
0122222222222222222222222222222222222222222222222210012210
0122222222222222222222222222222222222222222222222210012210
0111111111111111112211111122111111112211111111111110012210
0000000000000000012210000122100000012210000000000000012210
0000000000000000012210000122100000012210000000000000012210
0111111111111111112211111122111111112211111111111111112210
0122222222222222222222222222222222222222222222222222222210
0122222222222222222222222222222222222222222222222222222210
0111111111111111111111111111111111111111111111111111111110
0000000000000000000000000000000000000000000000000000000000