11111111111111111111111111111111
11000000000000000000000000000011
11000000000000000000000000000011
11000000000000000000000000000011
11000000000000000000000000000011
11000000000000000000000000000011
11000000000000000000000000000011
11000000000000000000000000000011
11000000000000000000000000000011
11220002222222222222222220002211
11000000000000000000000000000011
11000000000000000000000000000011
11000000000000000000000000000011
11000000000000000000000000000011
11220002222222222222222220002211
11000000000000000000000000000011
11000000000000000000000000000011
11000000000000000000000000000011
11000000000000000000000000000011
11220002222222222222222220002211
11000000000000000000000000000011
11000000040000000000000000000011
11000000000000000000300000000011
11000000000000000000000000000011
11222222222222222222222222222211