0000000000000000000000000000000000000000000000000000000000
0111111111111111111111111111111111111111111111111111111110
0122222222222222222222222225222222222222222222222222222210
0122222222222222222222222222222222222222222222222222222210
0122111122111111112211111111221111221111111122111111112210
0122100122100000012210000001221001221000000122100000012210
0122100122100000012210000001221001221000000122100000012210
0122100122111111112211111111221001221111111122111111112210
0122100122222222222222222222221001222222222222222222222210
0122100122222222222222222222221001222222222222222222222210
0122100122111111221111111111111001221111111111221111112210
0122100122100001221000000000000001221000000001221000012210
0122100122100001221000000000000001221000000001221000012210
0122111422111111221111111111111111221001111111221111112210
0122222222222222222222222222222222221001222222222222222210
0122222222222222222222222222222222221001222222222222222210
0122111122111111112211112211111111221001221111221111112210
0122100122100000012210012210000001221001221001221000012210
0122100122100000012210012210000001221001221001221000012210
0122100122111111112211112211111111221111221111221111112210
0122100122222222222222222222222222222222222222222222222210
0122100122222222222222222222222222222222222222222222222210
0122100122111122111122111111221111112211111111111111111110
0122100122100122100122100001221000012210000000000000000000
0122100122100122100122100001221000012210000000000000000000
0122111122111122111122100001221000012211111111111111111110
0122222222222222222222100001331000012222222222222222222210
0122222222222222222222100001331000012222222222222222222210
0111111111111111111122100001221000012211112211112211112210
0000000000000000000122100001221000012210012210012210012210
0000000000000000000722100001221000012210012210012210012210
0111111111111111111122111111221111112211112210012211112210
0122222222222222222222222222222222222222222210012222222210
0122222222222222222222222222222222222222222210012222222210
0122111111111111111122111111112211111111112210012211112210
0122100000000000000122100000012210000000012210012210012210
0122100000000000000122100000012210000000042210012210012210
0122100111111111111122111111112210011111112211112210012210
0122100122222222222222222222222210012222222222222210012210
0122100122222222222222222222222210012222222222222210012210
0122100122111111112211112211112210012211111111111110012210
0122100122100000012210012210012210012210000000000000012210
0122100122100000012210012210012210012210000000000000012210
0122111122111111112211112211112211112211111111111111112210
0122222222222222222222222222222222222222222222222222222210
0122222222222622222222222222222222222222222222222222222210
0122111122111122111111221111221111111122111111112211112210
0122100122100122100001221001221000000122100000012210012210
0122100122100122100001221001221000000122100000012210012210
0122111122111122111111221111221111111122111111112211112210
0122222222222222222222222222222222222222222222222222222210
0122222222222222222222222222222222222222222222222222222210
0111111111111111111111111111111111111111111111111111111110
0000000000000000000000000000000000000000000000000000000000