0000000000000000000000000000000000000000000000000000000000
0111111111111111111111100111111111111111411111111111111110
0122222222222222222222100122222222222222222222222222222210
0122222222222222222222100122222222222222222222222222222210
0122111122111122111122100122111111112211112211111111112210
0122100122100122100122100122100000012210012210000000012210
0122100122100122100122100122100000012210012210000000012210
0122111122111122100122100122111111112211112211111110012210
0122222222222222100122100122222222222222222222222210012210
0122222222222222100122100122222222222222222222222210012210
0122111111111111100122100122111111112211112211112210012210
0122100000000000000122100122100000012210012210012210012210
0122100000000000000122100122100000012210012210012210012210
0162111111111111111122100122111111112211112211112211112210
0122222222222222222222100122222222222222222222222222222210
0122222222222222222222100122222222222222222222222222222210
0122111122111122111122100122111111221111112211112211112210
0122100122100122100122100122100001221000012210012210012210
0122100122100122100122100422100001221000012210012210012210
0122100122100122111122111122111111221111112211172211112210
0122100122100122222222222222222222222222222222222222222210
0122100122100122222222222222222222222222222222222222222210
0122100122100122111122111111221111112211111111112211112210
0122100122100122100122100001221000012210000000012210012210
0122100122100122100122100001221000012210000000012210012210
0122111122111122111122100001221000012210011111112210012210
0122222222222222222222100001221000012210012222222210012210
0122222222222222222222100001221000012210012222222210012210
0122111111111122111122100001221000012210012211112210012210
0122100000000122100122100001221000012210012210012210012210
0122100000000122100122100001221000012210012210012210012210
0122100111111122111122111111221111142211112211112211112210
0122100122222222222222222222222222222222222222222222222210
0122100122222222222222222222222222222222222222222222222210
0122100122111111112211112211112211112211111111111111112210
0122100122100000012210012210012210012210000000000000012210
0122100122100000012210012210012210012210000000000000012210
0122111122111111112210012211112211112211111111111110012210
0122222222222222222210012222222222222222222222222210012210
0122222222222222222210012222222222222222222222222210012210
0111111111111111112210012211111111221111221111112210012210
0000000000000000012210012210000001221001221000012210012210
0000000000000000012210012210000001221001221000012210012210
0141111111111111112211112211111111221001221111112211112210
0122222222222222222222222222222222221001222222222222222210
0122222222222222222222222222222222221001222225222222222210
0122111122111122111122111122111111221001111111221111112210
0122100122100122100122100122100001221000000001221000012210
0122100122100122100122100122100001221000000001221000012210
0122111122111122111122111122111111221111111111221111112210
0122222222222222222222222222222222222222222222222222222210
0122222222222222222222222222222222222222222222222222222210
0111111111111111111111111111111111111111111111111111111110
0000000000000000000000000000000000000000000000000000000000